30 15
1 1 1 1 1 1 1 1 1 1 1 1 1 1 1 1 1 1 1 1 1 1 1 1 1 1 1 1 1 1
1 1 1 1 1 1 1 1 1 2 2 2 2 1 1 2 2 2 1 1 1 1 1 1 1 1 1 1 1 1
1 1 2 2 2 2 2 1 1 2 2 7 2 1 1 2 4 2 1 1 1 1 1 1 1 1 1 1 1 1
1 1 2 2 2 6 2 1 1 2 2 2 2 1 1 2 2 2 1 1 1 1 1 1 1 1 1 1 1 1
1 1 2 2 2 2 2 1 1 2 2 2 2 1 1 2 2 2 1 1 1 1 1 1 1 1 1 1 1 1
1 1 2 2 2 2 2 1 1 2 2 2 2 1 1 2 2 2 1 1 1 1 1 1 1 1 1 1 1 1
1 1 2 2 2 2 2 1 1 2 2 2 2 1 1 1 1 1 1 1 1 1 1 1 1 1 1 1 1 1
1 1 1 1 1 1 1 1 1 1 1 1 1 1 1 1 1 1 1 1 1 1 1 1 1 1 1 1 1 1
1 1 1 1 1 1 1 1 1 1 1 1 1 1 1 1 1 1 1 1 1 1 1 1 1 1 1 1 1 1
1 1 1 1 1 1 1 1 1 1 1 1 1 1 1 1 1 1 1 1 1 1 1 1 1 1 1 1 1 1
1 1 1 1 1 1 1 1 1 1 1 1 1 1 1 1 1 1 1 1 1 1 1 1 1 1 1 1 1 1
1 1 1 1 1 1 1 1 1 1 1 1 1 1 1 1 1 1 1 1 1 1 1 1 1 1 1 1 1 1
1 1 1 1 1 1 1 1 1 1 1 1 1 1 1 1 1 1 1 1 1 1 1 1 1 1 1 1 1 1
1 1 1 1 1 1 1 1 1 1 1 1 1 1 1 1 1 1 1 1 1 1 1 1 1 1 1 1 1 1
1 1 1 1 1 1 1 1 1 1 1 1 1 1 1 1 1 1 1 1 1 1 1 1 1 1 1 1 1 1

